8 8 
1 2 
8 6 

* ' * * * * * *
* ' ' ' ' ' ' *
* * ' * ' * * *
* ' ' * * * ' *
* ' * ' ' ' ' *
* ' ' ' * ' * *
* ' * ' * ' ' *
* * * * * ' * *