8 16
1 9
5 1

# # # # ^ # # # 
# # # ^ ^ # ^ # 
# ^ ^ ^ # # ^ # 
# ^ # # # ^ ^ # 
# ^ ^ # # ^ # # 
# # ^ # # ^ ^ # 
# ^ ^ ^ # # ^ # 
# # # ^ # # ^ # 
^ ^ # ^ # ^ ^ # 
# ^ # ^ # ^ # # 
# ^ # ^ ^ ^ ^ # 
# ^ # # # # ^ # 
# ^ ^ ^ ^ # ^ # 
# # ^ # ^ # ^ # 
# ^ ^ # ^ ^ ^ # 
# # # # # # # # 