8 8 
2 1 
6 8 

# ^ # # # # # #
# ^ ^ ^ ^ ^ ^ #
# # ^ # ^ # # #
# ^ ^ # # # ^ #
# ^ # ^ ^ ^ ^ #
# ^ ^ ^ # ^ # #
# ^ # ^ # ^ ^ #
# # # # # ^ # #