16 8
14 1 
16 6

# # # # # # # # # # # # # ^ # #
# ^ ^ ^ # # ^ # # ^ ^ ^ # ^ # #
# # ^ # ^ ^ ^ ^ ^ ^ # ^ ^ ^ ^ #
# ^ ^ # ^ # # # # # ^ ^ # # ^ #
# ^ # # ^ # ^ ^ ^ # # ^ ^ # # #
# ^ ^ ^ ^ ^ ^ # ^ # ^ # # ^ ^ ^
# ^ # ^ # ^ # ^ ^ ^ ^ ^ ^ ^ # #
# # # # # # # # # # # # # # # #